a broken home 	felbomlott család, feldúlt családi élet
a broken marriage 	tönkrement házasság
best man 	násznagy
boyfriend 	barát (párkapcsolatoknál)
bride 	menyasszony
bridegroom 	vőlegény
bridesmaid 	koszorúslány
couple 	pár
ex husband / wife 	volt férj / feleség
father-in-law 	após
fiancé 	vőlegény
fiancée 	menyasszony
future husband / wife 	jövendőbeli férj / feleség
girlfriend 	barátnő (párkapcsolatoknál)
honey weeks 	mézes hetek
honeymoon 	nászút
husband / wife to be 	jövendőbeli férj / feleség
husband 	férj
joy father 	örömapa
joy mother 	örömanya
master of ceremonies 	ceremóniamester
mother-in-law 	anyós
one-parent family 	csonka család
spouse 	hitves
superstition 	babona
to divorce sy 	elválik vkitől
to get divorced 	elválik
to get engaged 	eljegyez
to get married 	összeházasodik
to marry sy 	elvesz vkit feleségül, hozzámegy vkihez
to separate from sy 	különválik vkitől
wedding 	esküvő
wife 	feleség
